Agnes Nidsjö	Kindahls	
Amanda Karolak	KD	
Beatrice Albinsson	KD	
Ellinor Zetterström	Kindahls	
Filippa Uddenberg	Kindahls	
Hanna Härneman	Kindahls	
Isabelle Uddenberg	Kindahls	
Joel Persson	FLEX	
Lisa Trange	Kindahls	
Liv Henriksson	Kindahls	
Louise Lööf	Edge Uppsala	
Maria Vidic	SDC	
Mathias Balan	SDC	
Melina Axner Ellgren	Kindahls	
Miranda Nordheden	Kindahls	
Sara Engerdahl	SDC	
Sebastian Ljungdahl	DCL	
Smilla Skärbo	Laising	
Sofija Laurencikaite	KD	
Thea Dahlin	FLEX	
Tyra Hermansson	FLEX	
